------------------------------------------------
-    **                                    *   -
-                             *                -
-                      ?                   --- -
-                                              -
-            --                     --         -
-                             b                -
-   - .  1@    c -          -    m 2 .         -
-   ---------------    * -   -----------    * --
-                                              -
-                -  b                   -   .  -
-        **         --          **       . --  -
-                                        -     -
-         -  .   .   -  s   .    c    .  . . 9 -
------------------------------------------------