------------------------------------------------
-     ?           -                            -
-                 -            *     *         -
-          -   +  -   -                        -
-        ---- -----   -       ..    ...        -
-*         -          -      ----------  *     -
--         -  o -  P --                        -
-         -------  ----         ***         *  -
-         --                   -------       9 -
-          -                   -             ---
-*        --         ?        --               -
--         -         -         -     .         -
-          -         -         -     -         -
-   1   @  - p    h  -  h  - + - ? b -  b   b  -
------------------------------------------------