------------------------------------------------
-            --                     --         -
-            --                     --         -
-      .                      b                -
-- 2  ---        *          ---        *       -
-  --        *      ***   --        *      *** -
-      ?  `          ---                   --- -
-      ---                    ---              -
-       *       *              *       *       -
-                       -                      -
-   - .   1     o -          - m    2 .        -
-   ---------------    * -   -----------    * --
-                                              -
-                -  b                   -  9   -
-        **         --          **         --  -
-         ?                                    -
- p  c  @  c  P      c -  s         r.  . .  s -
------------------------------------------------