-------------------------
-                       -
-                       -
-                       -
-            --         -
-                       -
--    ---               -
-  --        *          -
-                   --- -
-      ---              -
-       *               -
-                       -
-   -    @              -
-   -----------        --
-                       -
-                -      -
-                   --  -
-                       -
-                       -
-------------------------