-------------------------
-    **             *   -
-                       -
-                       -
-            --         -
-                       -
--    ---        *      -
-  --        *      *** -
-                   --- -
-      ---              -
-       *       *       -
-                       -
-   -    @   .          -
-   -----------      * --
-                       -
-                -      -
-        **         --  -
-                       -
-  *  *  *    .  . .  . -
-------------------------